##########G#
#X#'''''##'#
###''##''''#
#'#''''''#'#
#''T'''T'''#
#''#'#''##'#
#'#X''X#'''#
##'#'''''''#
#''''''T'''#
#'#'''#''''#
#''''''''#'#
#S##########
