##########G#
#'''''#'#''#
#''''''''''#
#'T#'''''''#
##'''#'''''#
#''''X'''#'#
##'##'''''T#
#'''##''#'##
#'#''#'#T''#
#''#'''''''#
#'##'''X#'X#
#S##########
