##########G#
#'''#''''''#
#'''''''''T#
#''#''''#'X#
#''###'''''#
#''#'#''#''#
#'''#''X#''#
#'''''T'''##
#''''#'#'''#
##'#''X#'''#
#T''''###''#
#S##########
