##########G#
#''''T'''''#
#'#'''X''''#
#'#'''#'''##
#''''''''X'#
#'''X'X''###
##''''''''##
#'''''#''''#
#'X'T''X'''#
#T'''''''''#
#''''#'''''#
#S##########
