##########G#
#'#'''##'''#
#T#'''#''''#
#''#'T'''''#
#''##'''''X#
#'''#''''#T#
#'#''X'#'''#
##''#'''#''#
#'#'''''''##
#'#'''''''##
#''''X'''#'#
#S##########
