##########G#
#'#''''T'#'#
##'''''''''#
#''''#'#X''#
#'#'#XT''''#
#''''''''''#
#'#''''#'#'#
#'X'''''''##
####'#'#'''#
#T'''#'''#'#
#'''''#''#'#
#S##########
