##########G#
#''''''#'''#
#'###''''T##
#'#'#''''#'#
#X''###'#''#
#'''#'X'#''#
#''''#'#'''#
#''''''#'#'#
#''''X'''#'#
#'#'T''''''#
#'T''''''''#
#S##########
