##########G#
#'''##''#''#
#''''''''X'#
##'#''T''''#
#X''''#'''##
#''#''''#'X#
#''''''###'#
#'#''''''''#
#'#''''##''#
#T''''#''''#
#''##'T#'''#
#S##########
