##########G#
##'''''T#''#
#''#'''''''#
##''##'''''#
#'''X''##''#
###'#''##''#
#''''X''#''#
##T''''T'''#
##'X'''''''#
#'''''#''''#
#'''#'#'''##
#S##########
