##########G#
#''#'''''''#
#'#''''''#'#
#'''##''##'#
#'#'#''''''#
##'X''''#''#
#'''#'''''##
#'#'''#T'''#
#''''''''''#
#T'T#'#'#'##
#''X'X#''''#
#S##########
