##########G#
#'''#''#''T#
#'''##''''X#
#T''''X''#'#
#'''#''##''#
#'##''#''''#
###'#''#''##
#''''#'''''#
#''''''#'''#
###''''''''#
#''''''T'X'#
#S##########
