##########G#
#''T'''''''#
#'T'''#''''#
#''''''''''#
#'''X''#'''#
##''#''''''#
#''X''X''X'#
#'#''''''''#
#''''#'''''#
#'#X''''#''#
#X'''''#'#T#
#S##########
