##########G#
#'''''##'''#
#X'#'''''#'#
#'#'###''''#
#''''#''X#'#
#'X'T''''#'#
#'''''#'##'#
#''''#'''###
#''''''''''#
#T''''#'''##
#''#'''''T'#
#S##########
