##########G#
#'''''''X''#
#'''''''''##
##''''''#''#
#'''#'''#''#
#'###'''#''#
#'##'XT#'X'#
#''''#'#'''#
#''#''#''T'#
#''''''''###
#''#''#'T''#
#S##########
