##########G#
#''''''''''#
#'''X'''''##
#''''''#T''#
#'#''##'#''#
##'''#''#''#
#''#'''X'#'#
#''''T''X#'#
#''##'#''#'#
#'''##'''''#
#''''''T'###
#S##########
