##########G#
#'#''''#'X'#
#''#T''TT''#
#'''''''##'#
#'''''''####
#'''X'''''##
##'###'''''#
##'''''''#'#
#'''#''''''#
#'#''#'X'''#
#'#''''''#'#
#S##########
