##########G#
#'#'''''##'#
##'''XT''#'#
#''''''#'''#
#''''''#'''#
#'''T#'#'''#
#'''X''''T'#
##'##'#''#'#
#'''''''''##
#'#'#''#X''#
#'''#''''#'#
#S##########
