##########G#
#'''X''#'''#
#'''#''#'''#
#''##'#'X#'#
#'''''#''''#
#''''''T'''#
#''#''''''##
#''#'#'''''#
#'##'##'T''#
#''''#''''T#
#'''''X##'##
#S##########
