##########G#
#'''#''''''#
#T'''''''#'#
#'X'XT'''''#
#T''''#''''#
#'''X'#XX#'#
#''''''#'''#
#''''''#'''#
#'''''''#''#
#'X'''''''##
#''''#'''''#
#S##########
