##########G#
##'''#'''''#
#T''''#'''##
#'###''''''#
#T'''T'##''#
##''#X'''X##
##''#''''''#
#'''#'''#''#
#''#'''''''#
##X''''#'''#
#'''#''''''#
#S##########
