##################
#S''''''''#''''''R
####''##'''''''''R
#''''X''''''''E''R
#''''''''#'''''''R
#''''''''X'''''''R
#'''X'''#''''''''R
#''''''T'TX''''''R
#''''''''''''''''R
#''''T'''''''''''R
#X'X''''''''#''''R
#''''''E''#''''''R
#'''#''''''X'''''R
#''''''''''''T'''R
#''X''''#''''''''R
#''''''''X'''''''R
#''''''#'''''''''R
##################