##########G#
#''#'''''''#
##''''''####
#'''''''#'##
#'T##'''#''#
#'''#''##''#
#'''''T''#'#
#''''##''#'#
##''''X'X'##
##'''''''X'#
#'''T''''''#
#S##########
