##########G#
#'X''''''''#
#''''#'#'''#
##'''T'#'''#
#'X''##''#'#
#''''''''''#
##'''''#'#T#
###'''##'#'#
#'#'#''''#'#
#'''''#''''#
#''''#''T'X#
#S##########
