##########G#
##'''''''''#
##'''''X'#'#
#''#'#'''T'#
#'''''''#''#
#'#'#''''''#
##X#''#''#'#
##'''''''''#
###'''#'#'##
#''''''''TX#
#'#'''T'#''#
#S##########
