##########G#
#T'''''''T'#
#'''#''''''#
#'''''X''''#
#'''''XX'''#
#'''''#'''T#
#'###X'X''##
#'#''''''''#
#''''''''''#
#''''''#'#'#
#''#'''''X'#
#S##########
