##########S#######
R#''''''##'#'''''#
R#'''#'##''''#X''#
R'''#''''#'''''#'#
R''''''''''#'''''#
R''#''''''''#''''#
R#'''''#'###'X'#'#
R'''''#''##''''#'#
R'''''''#'#'''''##
R''''#'''''#'#'''#
R#'''''''#T''X'T'#
R#''''#''''#'''T'#
R#'#'''''''#'''''#
R''#'''''''#'''''#
R''''#'#'''''###'#
R#'''''''#''''''##
R''''''''''''##''#
##################
