######S###########
#'''''''''###'X''R
#''''''##''''''''R
#''#''''##'#'''''R
#''''''#''''#''''R
#'''''''''''##'''R
#'''''''#''''#'''R
##'##''#'''''''''R
#'#''''''##'###'#R
#X''''''''##'''##R
#'#''##'''''''''#R
#''#T'#''#'''''#'R
#''''#''''T''''''R
#'''#'X''#'''''''R
#''#'''''T'''''#'R
#''''#''''''#''''R
#''#''''###'#'''#R
##################
