##################
#'''''''#''''''###
#'''''''''''#'#''#
##'#''X'T'''#''''#
#'''#'##'''''#'X'#
##''''''#'##'''''#
##''''''###''''#'#
#'''''#'''''''##'#
##''''''#'##'''''#
##'''''''''''''''#
#''''''''''#'''''#
#''###''''''#'##'S
#''''#'''''''''''#
##'''#''''##'#'''#
##'''''''''#'T'''#
#''''''''''X#''''#
##'''#''#T##''#''#
#RRRRRRRRRRRRRRRR#
