##################
#''#'''#'''#'#'''#
#T#'####''''X'##'#
#'''''''''#'''#''#
##'''#'''''''''''#
#''#'''''''''#''##
#''''''''''#'''''#
#''''#'X''T#'''''#
S''''''''''#'##''#
#''''''##'#''''''#
#''''#''#'''''#''#
##''#''''''''#'#'#
#'''#'''#'#'#''''#
#'#''#''##'#'''''#
#''''#''#''''''#'#
#''#'''#'''#''X'T#
#'''''#''''''#'''#
#RRRRRRRRRRRRRRRR#
