##################
R'''''#'''''#''''#
R''#''#'#''''''''#
R'''#''''''##''#'#
R#''#'#''''''''''#
R''##''#'T#'#'#''#
R'''''''#''''''''S
R#''''''''''''#''#
R'''#'''''''T''''#
R'''''''''''T#'#'#
R''###'''###'''''#
R'''###''''''''''#
R#'#''''''X''''X'#
R#''#'''''''#''#'#
R'#'##'''''''#'#'#
R''''''X'''#'##'##
R''''#''''''#'#''#
##################
