##################
#'#'''#'''''###''R
#'''''#'#''''''''R
##'#'''''''''''##R
#'''''''''''''#''R
###''#'''''''''''R
#''X''''#'''''#T#R
#'''''''#'''#'''TR
S''''#'''##'#''##R
###'''#'''#'#''''R
#'''#'#''''''''''R
#'''''#X'''#''#'#R
#'##'''''''''#'''R
##''''''#''''''''R
#''#''''''''##''#R
#''X'##''''#'''''R
#'''''T''''##''''R
##################
