##################
S''''#'#'##'''''#R
#'''#''''''''''##R
#''''''''#'''''''R
#''''#''''#'####'R
#''''''#''#'X''#'R
#'#'''#'''#'#'#''R
#'#'#'#''''''#'''R
##''''''''''''#''R
#''''''X'''''T'''R
#''##''''##'##''#R
#'''##''#'#'''''#R
#'#''''#''''#'#''R
#'''''''#''''''''R
#X''''''#''''''T'R
#''''T'''''''''''R
#'''##'''#''#''''R
##################
