##################
#'''''''#''''T'''#
#'''#''''#''#''''#
#'#'#''#'''#'''''#
#X#''''#''T'#''###
#'#T'#'''''##''''#
#'''''#''#'''''''#
#'#''''''#'''''#G#
#'''#''''#'X'''''#
S'#'#''''##'''#''#
##''#''''''''''''#
#'''#'''''X''#'#'#
##'''''#'''#'#####
#''#''#''''#'''''#
#''''''''''''''''#
#'##''''#''''''''#
#'''''##'''#''#''#
##################
