##################
R''''###'''#'##''#
R''#'X'''''''#''X#
R'''''''X''''''''#
R'#''''#'#'#'''''#
R''''''''#'#'''''#
R#'''#''#''''''''S
R#'''''''#'''''''#
R'#'''#'''''#''''#
R'''''''''''#''''#
R''##'#'####'''#'#
R''''''''''#'''#'#
R''''''''#'##'#'##
R''#'''##'#''''#'#
R''''''T''''###''#
R'''T'''''#'##'''#
R'''''''''''T#'#'#
##################
