##################
#''''#''''#''''''R
#'####'''''#'''''R
#''''''''#'##''''R
#'''''''''#'''''#R
#'''##''##''''#''R
#'#''''#'''##''''R
#X'''''''#''#'##'R
S''''''''''''''''R
#'''#''''''#T##'#R
#X'#''''#'#''#'##R
#X'#''''''##''''TR
#T'''''''''''''''R
#'''''#''#''#''''R
##''''''''#''''''R
#'#''#'#''''''''#R
##'#'''''#'''''''R
##################
