##################
###'''''''#''''''R
#'''''#'#''''''''R
#''''#'''''X''#''R
#'#'#'#''#''#'#''R
#'''#'''''X''##''R
#''#X##''''''''#'R
#'''''''#'''''#''R
S''''''#'#'''#''#R
#''#''''''#'#''''R
#''#'##''''''''''R
##'T#'''#'''''#'#R
#''''#'''T''''#''R
#''''''#'''''''''R
#'#'''''''#''##'#R
#''''''''#''''#''R
#''''T''''#'#'##'R
##################
