##################
#'X'''''''''#'''#R
#'''#''###'#'''''R
####''#'''''''''#R
#''#'''''''''''''R
#''''#''X''''#'''R
#'''#'''''''#''##R
#''''#'#'''''#''#R
#'''''''#''''#'#'R
#T'''''''#'''#'''R
#''''#'''''''''''R
S''#T##'#''''''##R
#'''#'#''''''#X'#R
#'''''''''#'##'''R
##'''''''''''''''R
#'''T'''''##'''''R
#'#'###'#''''''#'R
##################
